######################
#E      ##########C###
####U##    ####      #
#### #####L     #### #
####   ###### ######F#
######################